5
5
1S111
10101
11110
01010
E1110
5
5
S1011
10001
10111
11010
000E0
7
7
S001100
1001110
1111110
1011010
1011110
0010010
0E10110
7
7
100S000
1001000
1101110
1001010
1001110
1100010
0E00010
10
15
00S000000000000
011110111101110
000010010111100
010010010100110
011111111110011
010000010111010
000111110110110
001110111000100
001011101011100
00E110101110000
20
20
S0111111111111111111
10100000000000000001
10101111111111111101
10101000000000000101
10101011111111110101
10101010000000010101
10101010111111010101
10101010100001010101
10101010111101010101
10101010100101010101
10101010100101010101
10101010111101010101
10101010000101010101
10101011111101010101
10101000000001010101
10101111111111010101
10100000000000010101
10111111111111110101
10000000000000000101
1111111111111111110E
20
20
S0111111111111111111
10100000000000000001
10101111111111111101
10101000000000000101
10101011111111110101
10101010000000010101
10101010111111010101
10101010100001010101
10101010101101010101
10101010100101010101
10101010100101010101
10101010110101010101
10101010000101010101
10101011111101010101
10101000000001010101
10101111111111010101
10100000000000010101
10111111111111110101
10000000000000000101
1111111111111111110E
20
20
0S000000000000000000
01111111111111111110
01111111111111111110
01111111111111111110
01111111111111111110
01111111111111111110
01111111111111111110
01111111111111111110
01111111111111111110
01111111111111111110
01111111111111111110
01111111111111111110
01111111111111111110
01111111111111111110
01111111111111111110
01111111111111111110
01111111111111111110
01111111111111111110
01111111111111111110
000000000000000000E0